10 10
1 1
4 9
0000010000
0111010110
0100000100
0101111100
0001000000
0101000100
0101110100
0000000000
0111111110
0000000000

